
MAPA da fase

						        A11 - A12 - CHEFE - A13
				             A10
A1 - A2 - A3               A9
          A4            A8
		  A5 - A6  - A7 

# A1

-------------------------------------------------------------------------------
-------------------------------------------------------------------------------
5-5-5-5-5-5-5-5-5-5--55--5-5-5-5-5-5-5--5--5-5-5--5-5-5-5-5-5--5----5-5-5-5----
-------------------------------------------------------------------------------
-----1------------------------------1---------------------1--------------------
-------------------------------------------------------------------------------
-----------------------------------------------1-------------------------------
----------1------1-----------------------------------------------1-------------
-------------------------------------------------------------------------------
--------------1---------------1--------------1---------------------------------
-------------------------------------------------------------------------------
------------------------------------------------------------------1------------
-----1-------------------------------------------------------------------------
-------------------------------------------------------------------------------
-2---2-----2------3-------2-2-2-2-2-2--2--2--2------3-------2-2-2-2-2-2-2-2-2-2
-----------2------3-------2------------------2------3-------2------------------
-----------2------3-------2------------------2------3-------2------------------
-----------2------3-------2------------4-----2------3-------2------------------
-----------2------3-------2------------------2------3-------2------------------
-----------2------3-------2------------------2------3-------2------------------

  1 = fundo tecnológico (com diversas variações de cores e detalhes espalhados, 
  alguns com 2 frames piscando luzes, ou alternando uma luz de emergência) - tipo 20 painéis diferentes montados!

  2 = plataforma em uma estrutura de metal tipo elevador... algo cheio de tubos e maquinaria (ver dentro de um motor)

  3 = espaço vazio, e a nave dos players (1,2) sobem por ali (quem sabe umas marcas de tinta de setas indicando [Gate A]?)
      - as indicações podem ser com grafias sujas ... as sobem sozinhas, sem elevador

  4 = algum detalhe bacana no centro (pensar! pode ser algo girando ou oscilando)

  5 = plataforma superior com algum vidro mostrando o espaço

  (nenhum inimigo, e a tela vai se deslocando devagar


